-17 -8 0 1 1 1 1 
-17 -7 0 1 1 1 1 
-17 -6 0 1 1 1 1 
-17 -5 0 1 1 1 1 
-17 -4 0 1 1 1 1 
-17 -3 0 1 1 1 1 
-17 -1 0 1 1 1 1 
-17 0 0 1 1 1 1 
-17 -2 0 1 1 1 1 
-17 1 0 1 1 1 1 
-17 2 0 1 1 1 1 
-17 3 0 1 1 1 1 
-17 4 0 1 1 1 1 
-17 5 0 1 1 1 1 
-17 6 0 1 1 1 1 
-17 7 0 1 1 1 1 
-17 8 0 1 1 1 1 
-17 9 0 1 1 1 1 
-17 10 0 1 1 1 1 
-16 10 0 1 1 1 1 
-15 10 0 1 1 1 1 
-14 10 0 1 1 1 1 
-13 10 0 1 1 1 1 
-12 10 0 1 1 1 1 
-11 10 0 1 1 1 1 
-10 10 0 1 1 1 1 
-9 10 0 1 1 1 1 
-8 10 0 1 1 1 1 
-7 10 0 1 1 1 1 
-6 10 0 1 1 1 1 
-5 10 0 1 1 1 1 
-4 10 0 1 1 1 1 
-3 10 0 1 1 1 1 
-2 10 0 1 1 1 1 
-1 10 0 1 1 1 1 
0 10 0 1 1 1 1 
1 10 0 1 1 1 1 
2 10 0 1 1 1 1 
3 10 0 1 1 1 1 
4 10 0 1 1 1 1 
5 10 0 1 1 1 1 
6 10 0 1 1 1 1 
7 10 0 1 1 1 1 
8 10 0 1 1 1 1 
9 10 0 1 1 1 1 
10 10 0 1 1 1 1 
11 10 0 1 1 1 1 
12 10 0 1 1 1 1 
13 10 0 1 1 1 1 
14 10 0 1 1 1 1 
15 10 0 1 1 1 1 
16 10 0 1 1 1 1 
17 9 0 1 1 1 1 
17 8 0 1 1 1 1 
17 7 0 1 1 1 1 
17 10 0 1 1 1 1 
17 6 0 1 1 1 1 
17 5 0 1 1 1 1 
17 4 0 1 1 1 1 
17 3 0 1 1 1 1 
17 2 0 1 1 1 1 
17 1 0 1 1 1 1 
17 0 0 1 1 1 1 
17 -1 0 1 1 1 1 
17 -2 0 1 1 1 1 
17 -3 0 1 1 1 1 
17 -4 0 1 1 1 1 
17 -5 0 1 1 1 1 
17 -6 0 1 1 1 1 
17 -7 0 1 1 1 1 
17 -8 0 1 1 1 1 
17 -9 0 1 1 1 1 
16 -9 0 1 1 1 1 
15 -9 0 1 1 1 1 
14 -9 0 1 1 1 1 
13 -9 0 1 1 1 1 
12 -9 0 1 1 1 1 
11 -9 0 1 1 1 1 
10 -9 0 1 1 1 1 
8 -9 0 1 1 1 1 
7 -9 0 1 1 1 1 
9 -9 0 1 1 1 1 
6 -9 0 1 1 1 1 
5 -9 0 1 1 1 1 
4 -9 0 1 1 1 1 
3 -9 0 1 1 1 1 
2 -9 0 1 1 1 1 
1 -9 0 1 1 1 1 
0 -9 0 1 1 1 1 
-1 -9 0 1 1 1 1 
-2 -9 0 1 1 1 1 
-3 -9 0 1 1 1 1 
-4 -9 0 1 1 1 1 
-5 -9 0 1 1 1 1 
-6 -9 0 1 1 1 1 
-7 -9 0 1 1 1 1 
-8 -9 0 1 1 1 1 
-9 -9 0 1 1 1 1 
-10 -9 0 1 1 1 1 
-11 -9 0 1 1 1 1 
-12 -9 0 1 1 1 1 
-13 -9 0 1 1 1 1 
-14 -9 0 1 1 1 1 
-15 -9 0 1 1 1 1 
-16 -9 0 1 1 1 1 
-17 -9 0 1 1 1 1 
-12 -8 0 1 1 1 1 
-11 -7 0 1 1 1 1 
-10 -6 0 1 1 1 1 
-9 -5 0 1 1 1 1 
-8 -4 0 1 1 1 1 
-8 -5 0 1 1 1 1 
-8 -6 0 1 1 1 1 
-8 -7 0 1 1 1 1 
-8 -8 0 1 1 1 1 
-9 -8 0 1 1 1 1 
-10 -8 0 1 1 1 1 
-11 -8 0 1 1 1 1 
-9 -7 0 1 1 1 1 
-9 -6 0 1 1 1 1 
-10 -7 0 1 1 1 1 
8 -4 0 1 1 1 1 
8 -5 0 1 1 1 1 
8 -6 0 1 1 1 1 
8 -7 0 1 1 1 1 
8 -8 0 1 1 1 1 
8 -3 0 1 1 1 1 
8 -2 0 1 1 1 1 
8 -1 0 1 1 1 1 
9 -1 0 1 1 1 1 
10 -1 0 1 1 1 1 
11 -1 0 1 1 1 1 
12 -1 0 1 1 1 1 
13 -1 0 1 1 1 1 
14 -1 0 1 1 1 1 
15 -1 0 1 1 1 1 
16 -1 0 1 1 1 1 
16 0 0 1 1 1 7 
7 -8 0 1 1 1 2 
6 -8 0 1 1 1 2 
7 -7 0 1 1 1 2 
-4 -2 0 0.5 0.5 0.5 5 
-2 0 0 0.5 0.5 0.5 5 
1 1 0 0.5 0.5 0.5 5 
2 1 0 0.5 0.5 0.5 5 
5 1 0 0.5 0.5 0.5 5 
7 1 0 0.5 0.5 0.5 5 
-15 -7 0 1 1 1 6 
