-13 -9 0 1 1 1 1 
-14 -9 0 1 1 1 1 
-15 -9 0 1 1 1 1 
-16 -9 0 1 1 1 1 
-17 -9 0 1 1 1 1 
-17 -8 0 1 1 1 1 
-17 -7 0 1 1 1 1 
-17 -6 0 1 1 1 1 
-17 -5 0 1 1 1 1 
-17 -4 0 1 1 1 1 
-17 -3 0 1 1 1 1 
-17 -2 0 1 1 1 1 
-17 -1 0 1 1 1 1 
-17 0 0 1 1 1 1 
-17 1 0 1 1 1 1 
-17 2 0 1 1 1 1 
-17 3 0 1 1 1 1 
-17 4 0 1 1 1 1 
-17 5 0 1 1 1 1 
-17 6 0 1 1 1 1 
-17 7 0 1 1 1 1 
-17 8 0 1 1 1 1 
-17 9 0 1 1 1 1 
-17 10 0 1 1 1 1 
-16 10 0 1 1 1 1 
-15 10 0 1 1 1 1 
-14 10 0 1 1 1 1 
-13 10 0 1 1 1 1 
-12 10 0 1 1 1 1 
-10 10 0 1 1 1 1 
-9 10 0 1 1 1 1 
-8 10 0 1 1 1 1 
-11 10 0 1 1 1 1 
-7 10 0 1 1 1 1 
-6 10 0 1 1 1 1 
-5 10 0 1 1 1 1 
-4 10 0 1 1 1 1 
-3 10 0 1 1 1 1 
-2 10 0 1 1 1 1 
-1 10 0 1 1 1 1 
0 10 0 1 1 1 1 
1 10 0 1 1 1 1 
2 10 0 1 1 1 1 
3 10 0 1 1 1 1 
4 10 0 1 1 1 1 
5 10 0 1 1 1 1 
6 10 0 1 1 1 1 
7 10 0 1 1 1 1 
8 10 0 1 1 1 1 
9 10 0 1 1 1 1 
10 10 0 1 1 1 1 
11 10 0 1 1 1 1 
12 10 0 1 1 1 1 
13 10 0 1 1 1 1 
14 10 0 1 1 1 1 
15 10 0 1 1 1 1 
16 10 0 1 1 1 1 
17 10 0 1 1 1 1 
17 9 0 1 1 1 1 
17 8 0 1 1 1 1 
17 7 0 1 1 1 1 
17 6 0 1 1 1 1 
17 5 0 1 1 1 1 
17 4 0 1 1 1 1 
17 3 0 1 1 1 1 
17 2 0 1 1 1 1 
17 1 0 1 1 1 1 
17 0 0 1 1 1 1 
17 -1 0 1 1 1 1 
17 -2 0 1 1 1 1 
17 -3 0 1 1 1 1 
17 -4 0 1 1 1 1 
17 -5 0 1 1 1 1 
17 -6 0 1 1 1 1 
17 -7 0 1 1 1 1 
17 -8 0 1 1 1 1 
17 -9 0 1 1 1 1 
16 -9 0 1 1 1 1 
15 -9 0 1 1 1 1 
14 -9 0 1 1 1 1 
13 -9 0 1 1 1 1 
12 -9 0 1 1 1 1 
11 -9 0 1 1 1 1 
10 -9 0 1 1 1 1 
9 -9 0 1 1 1 1 
8 -9 0 1 1 1 1 
7 -9 0 1 1 1 1 
6 -9 0 1 1 1 1 
5 -9 0 1 1 1 1 
4 -9 0 1 1 1 1 
3 -9 0 1 1 1 1 
2 -9 0 1 1 1 1 
1 -9 0 1 1 1 1 
0 -9 0 1 1 1 1 
-1 -9 0 1 1 1 1 
-2 -9 0 1 1 1 1 
-3 -9 0 1 1 1 1 
-4 -9 0 1 1 1 1 
-5 -9 0 1 1 1 1 
-6 -9 0 1 1 1 1 
-7 -9 0 1 1 1 1 
-8 -9 0 1 1 1 1 
-9 -9 0 1 1 1 1 
-10 -9 0 1 1 1 1 
-11 -9 0 1 1 1 1 
-12 -9 0 1 1 1 1 
16 8 0 1 1 1 7 
16 7 0 1 1 1 1 
15 7 0 1 1 1 1 
14 7 0 1 1 1 1 
13 7 0 1 1 1 1 
12 7 0 1 1 1 1 
11 7 0 1 1 1 1 
10 7 0 1 1 1 1 
7 4 0 1 1 1 1 
6 4 0 1 1 1 1 
5 4 0 1 1 1 1 
4 4 0 1 1 1 1 
3 4 0 1 1 1 1 
-16 -5 0 1 1 1 1 
-15 -5 0 1 1 1 1 
-14 -5 0 1 1 1 1 
-13 -5 0 1 1 1 1 
-12 -5 0 1 1 1 1 
-11 -5 0 1 1 1 1 
-10 -5 0 1 1 1 1 
-9 -5 0 1 1 1 1 
-8 -5 0 1 1 1 1 
-8 -8 0 1 1 1 1 
-1 -8 0 1 1 1 1 
-1 -7 0 1 1 1 1 
-1 -6 0 1 1 1 1 
-1 -5 0 1 1 1 1 
-4 -2 0 1 1 1 1 
-3 -2 0 1 1 1 1 
-5 -2 0 1 1 1 1 
-6 -2 0 1 1 1 1 
-7 -2 0 1 1 1 1 
-7 -3 0 1 1 1 1 
-2 -2 0 1 1 1 1 
0 -2 0 1 1 1 1 
1 -2 0 1 1 1 1 
-1 -2 0 1 1 1 1 
2 -2 0 1 1 1 1 
4 -2 0 1 1 1 1 
3 -2 0 1 1 1 1 
5 -3 0 1 1 1 1 
5 -2 0 1 1 1 1 
6 -2 0 1 1 1 1 
7 -2 0 1 1 1 1 
8 -2 0 1 1 1 1 
9 -2 0 1 1 1 1 
10 -8 0 1 1 1 2 
11 -7 0 1 1 1 2 
12 -8 0 1 1 1 2 
13 -7 0 1 1 1 2 
14 -8 0 1 1 1 2 
15 -7 0 1 1 1 2 
16 -8 0 1 1 1 2 
15 -3 0 1 1 1 2 
16 -3 0 1 1 1 2 
16 1 0 1 1 1 2 
15 1 0 1 1 1 2 
0 2 0 1 1 1 1 
1 2 0 1 1 1 1 
2 2 0 1 1 1 1 
2 3 0 1 1 1 1 
-7 -1 0 1 1 1 1 
-7 0 0 1 1 1 1 
-10 3 0 1 1 1 1 
-11 3 0 1 1 1 1 
-12 3 0 1 1 1 1 
-13 3 0 1 1 1 1 
-14 3 0 1 1 1 1 
-15 3 0 1 1 1 1 
-16 3 0 1 1 1 1 
-7 7 0 1 1 1 2 
-7 8 0 1 1 1 2 
-7 9 0 1 1 1 2 
-5 -6 0 0.5 0.5 0.5 5 
3 -6 0 0.5 0.5 0.5 5 
12 -4 0 0.5 0.5 0.5 5 
15 4 0 0.5 0.5 0.5 5 
6 0 0 0.5 0.5 0.5 5 
-4 3 0 0.5 0.5 0.5 5 
4 7 0 0.5 0.5 0.5 5 
-14 7 0 0.5 0.5 0.5 5 
-13 -2 0 0.5 0.5 0.5 5 
-7 1 0 1 1 1 1 
-7 2 0 1 1 1 1 
-7 6 0 1 1 1 2 
-7 5 0 1 1 1 2 
-15 -7 0 1 1 1 6 
