0 -4 0 1 1 1 1 
1 -4 0 1 1 1 1 
2 -4 0 1 1 1 1 
3 -4 0 1 1 1 1 
4 -4 0 1 1 1 1 
5 -4 0 1 1 1 1 
6 -4 0 1 1 1 1 
7 -4 0 1 1 1 1 
8 -4 0 1 1 1 1 
9 -4 0 1 1 1 1 
10 -4 0 1 1 1 1 
11 -4 0 1 1 1 1 
12 -4 0 1 1 1 1 
13 -4 0 1 1 1 1 
14 -4 0 1 1 1 1 
14 -3 0 1 1 1 1 
14 -2 0 1 1 1 1 
14 -1 0 1 1 1 1 
14 0 0 1 1 1 1 
14 1 0 1 1 1 1 
14 2 0 1 1 1 1 
14 3 0 1 1 1 1 
14 4 0 1 1 1 1 
14 5 0 1 1 1 1 
14 6 0 1 1 1 1 
14 7 0 1 1 1 1 
14 8 0 1 1 1 1 
14 9 0 1 1 1 1 
14 10 0 1 1 1 1 
13 10 0 1 1 1 1 
12 10 0 1 1 1 1 
11 10 0 1 1 1 1 
10 10 0 1 1 1 1 
9 10 0 1 1 1 1 
8 10 0 1 1 1 1 
7 10 0 1 1 1 1 
6 10 0 1 1 1 1 
5 10 0 1 1 1 1 
4 10 0 1 1 1 1 
3 10 0 1 1 1 1 
2 10 0 1 1 1 1 
1 10 0 1 1 1 1 
0 10 0 1 1 1 1 
-1 10 0 1 1 1 1 
-3 10 0 1 1 1 1 
-4 10 0 1 1 1 1 
-5 10 0 1 1 1 1 
-6 10 0 1 1 1 1 
-7 10 0 1 1 1 1 
-2 10 0 1 1 1 1 
-8 10 0 1 1 1 1 
-9 10 0 1 1 1 1 
-10 10 0 1 1 1 1 
-11 10 0 1 1 1 1 
-12 10 0 1 1 1 1 
-13 10 0 1 1 1 1 
-14 10 0 1 1 1 1 
-15 10 0 1 1 1 1 
-15 9 0 1 1 1 1 
-15 8 0 1 1 1 1 
-15 7 0 1 1 1 1 
-15 6 0 1 1 1 1 
-15 5 0 1 1 1 1 
-15 4 0 1 1 1 1 
-15 3 0 1 1 1 1 
-15 2 0 1 1 1 1 
-15 1 0 1 1 1 1 
-15 0 0 1 1 1 1 
-15 -1 0 1 1 1 1 
-15 -2 0 1 1 1 1 
-15 -3 0 1 1 1 1 
-15 -4 0 1 1 1 1 
-14 -4 0 1 1 1 1 
-13 -4 0 1 1 1 1 
-12 -4 0 1 1 1 1 
-11 -4 0 1 1 1 1 
-10 -4 0 1 1 1 1 
-9 -4 0 1 1 1 1 
-8 -4 0 1 1 1 1 
-7 -4 0 1 1 1 1 
-6 -4 0 1 1 1 1 
-5 -4 0 1 1 1 1 
-4 -4 0 1 1 1 1 
-3 -4 0 1 1 1 1 
-2 -4 0 1 1 1 1 
-1 -4 0 1 1 1 1 
-3 -2 0 1 1 1 2 
-2 -3 0 1 1 1 2 
-4 -1 0 1 1 1 2 
-5 0 0 1 1 1 2 
-6 1 0 1 1 1 2 
-7 0 0 1 1 1 2 
-8 -1 0 1 1 1 2 
-9 -2 0 1 1 1 2 
-10 -3 0 1 1 1 2 
-9 3 0 0.5 0.5 0.5 5 
4 -1 0 0.5 0.5 0.5 5 
13 -3 0 1 1 1 7 
-13 -2 0 1 1 1 6 
-6 5 0 0.5 0.5 0.5 5 
-2 3 0 0.5 0.5 0.5 5 
1 1 0 0.5 0.5 0.5 5 
